EA ./asdasdas
NO ./asdasdas
WE >?sadddw
S ./qwqwqqqqqq
SO ./assssssss
F 123, 123 ,123
C 74, 2, 86
R 2000 2000















11111111
100000011
100000001
100000001   11111111
10000000111110000001   
1000S100000000020001
10000001111111111111
10000001
10000001111111111
10002000000000001
10000100111000001
100000001 1000001
111111111 1000001
          1111111