11111110000000000000
000000002222200202002020020
111112122121212000000
00
000000001111
2
2
22
222222
00000
0
0
0
0000
000
0
00
000