EA ./textures/wood.xpm
WE ./textures/greystone.xpm
NO ./textures/mossy.xpm
S ./textures/barrel.xpm
SO ./textures/redbrick.xpm
F 0, 0 , 255
C 255, 0, 0
R 1024 760

11111111111111111111111111
1E000200002000002222222221
10000000020000200200020201
11111111111111111111111111