EA ./textures/wood.xpm
WE ./textures/greystone.xpm
NO ./textures/mossy.xpm
S ./textures/barrel.xpm
SO ./textures/redbrick.xpm
F 123, 123 ,123
C 74, 2, 86
R 1024 760

11111111111111111111111111
1E000000000000000000000001
10000000000000000000000001
1200000000000000000000001
1000000000000000000000001
1000202000000000000000001
1111111111111111111111111