EA ./textures/wood.xpm
WE ./textures/greystone.xpm
NO ./textures/mossy.xpm
S ./textures/barrel.xpm
SO ./textures/redbrick.xpm
F 123, 123 ,123
C 74, 2, 86
R 1024 760

11111111111
1E000000021
11111111111