EA ./textures/redbrick.xpm
NO ./textures/greystone.xpm
WE ./textures/mossy.xpm
S ./textures/barrel.xpm
SO ./textures/wood.xpm
F 123, 123 ,123
C 74, 2, 86
R 1024 760

11111111111111111111
10000000000000000001
10000000222000000001
10001220000000000001
100200000E0000000001   
12000000000000020001
12000000000100000001
10200220000000002001
10000000101000000001
10002000111000000001
10000000111000001011
100000001 1000001111
111111111 1000001
          1111111