

11111111
1000000111111111
100000001
100000001   11111111
10000000111110000001   
10000000000000020001
10000000111111111111
100020001
100000001
100000001
111111111