EA ./textures/wood.xpm
WE ./textures/greystone.xpm
NO ./textures/mossy.xpm
S ./textures/barrel.xpm
SO ./textures/redbrick.xpm
F 0, 0 , 255
C 255, 0, 0
R 1024 760

11111111111111111111111111
12220000W000000000000000001
122200000000000000000000001
11111111111000001111111111
           100011000000001
           111000000011111
        11100000000111
        10000000000001
        10000000000001
        11111111111111