EA ./textures/wood.xpm
WE ./textures/greystone.xpm
NO ./textures/mossy.xpm
S ./textures/barrel.xpm
SO ./textures/redbrick.xpm
F 255, 100, 50
C 255, 0, 255
R 1000 800

1111111111
1000000001
1000000001
1S10000001
1011101111
111 101
    101
    101
    101
    101
    101
    101
    101
    101
    111